{
  "type" : "BombPuzzle",
  "version" : 0,
  "stages" : [
    {
      "mino_list" : [
        {
          "id" : 1,
          "type" : 0,
          "bomb" : -1
        },
        {
          "id" : 2,
          "type" : 0,
          "bomb" : 0
        }
      ],
      "gravity" : 0,
      "lock" : 0,
      "field" : [
	    [0,1,0,1,0,1,0,1,0,1],
	    [0,1,0,1,0,1,0,1,0,1],
	    [0,1,0,1,0,1,0,1,0,1],
	    [0,1,0,1,0,64,0,1,0,1],
	    [0,1,0,1,0,1,0,1,0,0],
	    [0,1,0,1,0,1,0,1,0,0],
	    [0,1,0,1,0,1,0,1,0,0],
	    [0,1,0,1,0,1,0,1,0,0],
	    [1,1,1,64,1,1,64,1,1,0],
	    [1,0,1,0,1,0,1,0,1,0],
	    [1,0,1,0,1,0,1,0,1,0],
	    [1,0,1,0,1,0,1,0,1,0],
	    [1,0,1,0,1,0,1,0,1,0],
	    [1,0,1,0,1,0,1,0,1,0],
	    [1,0,1,0,1,0,1,0,1,0],
	    [1,0,1,0,1,0,1,0,1,0],
	    [1,0,1,0,1,0,1,0,1,0]
      ]
    },
    {
      "mino_list" : [
        {
          "id" : 1,
          "type" : 0,
          "bomb" : -1
        },
        {
          "id" : 2,
          "type" : 0,
          "bomb" : 0
        }
      ],
      "gravity" : 0,
      "lock" : 0,
      "field" : [
	    [0,1,0,1,0,1,0,1,0,1],
	    [0,1,0,1,0,1,0,1,0,1],
	    [0,1,0,1,0,1,0,1,0,1],
	    [0,1,0,1,0,64,0,1,0,1],
	    [0,1,0,1,0,1,0,1,0,0],
	    [0,1,0,1,0,1,0,1,0,0],
	    [0,1,0,1,0,1,0,1,0,0],
	    [0,1,0,1,0,1,0,1,0,0],
	    [1,1,1,64,1,1,64,1,1,0],
	    [1,0,1,0,1,0,1,0,1,0],
	    [1,0,1,0,1,0,1,0,1,0],
	    [1,0,1,0,1,0,1,0,1,0],
	    [1,0,1,0,1,0,1,0,1,0],
	    [1,0,1,0,1,0,1,0,1,0],
	    [1,0,1,0,1,0,1,0,1,0],
	    [1,0,1,0,1,0,1,0,1,0],
	    [1,0,1,0,1,0,1,0,1,0]
      ]
    }
  ]
}